Alina Oprea	Northeastern University
Hovav Shacham	The University of Texas at Austin
Manos Antonakakis	Georgia Institute of Technology
Davide Balzarotti	Eurecom
Adam Bates	University of Illinois at Urbana-Champaign
Konstantin (Kosta) Beznosov	University of British Columbia
Karthikeyan Bhargavan	INRIA
Battista Biggio	University of Cagliari, Italy
Leyla Bilge	Symantec
Marina Blanton	University at Buffalo
Joseph Bonneau	NYU
Chris Brzuska	Aalto University
Kevin Butler	University of Florida
Juan Caballero	IMDEA Software Institute
Joe Calandrino	Federal Trade Commission
Aylin Caliskan	The George Washington University
Nicholas Carlini	Google
Melissa Chase	Microsoft Research
Stephen Checkoway	Oberlin College
Haibo Chen	Shanghai Jiao Tong University
David Choffnes	Northeastern University
Omar Chowdhury	The University of Iowa
Nicolas Christin	Carnegie Mellon University
Mihai Christodorescu	Visa Research
Henry Corrigan-Gibbs	Stanford University
Véronique Cortier	CNRS, Loria, France
Lorrie Cranor	Carnegie Mellon University
Weidong Cui	Microsoft Research
Emiliano De Cristofaro	University College London
Brendan Dolan-Gavitt	NYU
Adam Doupé	Arizona State University
Thomas Dullien	optimyze
Annie Edmundson	Squarespace
Manuel Egele	Boston University
Roya Ensafi	University of Michigan
Sascha Fahl	Leibniz University Hannover
Giulia Fanti	Carnegie Mellon University
Nick Feamster	Princeton
Anders Fogh	Intel Corporation
Aurélien Francillon	EURECOM
Michael Franz	University of California, Irvine
Christina Garman	Purdue University
Daniel Genkin	University of Michigan
Rosario Gennaro	The City College of New York
Cristiano Giuffrida	VU Amsterdam
Virgil Gligor	CMU
Ian Goldberg	University of Waterloo
Guofei Gu	Texas A&M University
Andreas Haeberlen	University of Pennsylvania
Thorsten Holz	Ruhr-Universität Bochum
Amir Houmansadr	University of Massachusetts Amherst
Limin Jia	Carnegie Mellon University
Brent ByungHoon Kang	KAIST
Alexandros Kapravelos	North Carolina State University
Aniket Kate	Purdue University
Stefan Katzenbeisser	TU Darmstadt
Aggelos Kiayias	University of Edinburgh & IOHK
Engin Kirda	Northeastern University
David Kohlbrenner	UC Berkeley
Vladimir Kolesnikov	Georgia Institute of Technology
Ralf Kuesters	University of Stuttgart
Wenke Lee	Georgia Institute of Technology
Anja Lehmann	IBM
Kirill Levchenko	University of Illinois
Dave Levin	UMD
Bo Li	UIUC
Xiaojing Liao	Indiana University Bloomington
Martina Lindorfer	TU Wien
Long Lu	Northeastern University
Matteo Maffei	TU Wien
Sergio Maffeis	Imperial College London
Piotr Mardziel	Carnegie Mellon University
Clémentine Maurice	CNRS, IRISA
Prateek Mittal	Princeton University
Payman Mohassel	Visa Research
Fabian Monrose	UNC
Neha Narula	MIT Media Lab
Nick Nikiforakis	Stony Brook University
Daniela Oliveira	University of Florida
Yossi Oren	Ben Gurion University
Nicolas Papernot	Google Brain
Mathias Payer	EPFL
Marcus Peinado	Microsoft Research
Roberto Perdisci	University of Georgia and Georgia Institute of Technology
Adrian Perrig	ETH Zurich
Frank Piessens	KU Leuven
Christina Poepper	New York University Abu Dhabi
Michalis Polychronakis	Stony Brook University
Raluca Ada Popa	UC Berkeley
Zhiyun Qian	University of California, Riverside
Ananth Raghunathan	Google
Aanjhan Ranganathan	Northeastern University
Kasper Rasmussen	University of Oxford
Eric Rescorla	Mozilla
Konrad Rieck	TU Braunschweig
Tom Ristenpart	Cornell Tech
William Robertson	Northeastern University
Joanna Rutkowska	Golem Project
Nitesh Saxena	University of Alabama at Birmingham
Prateek Saxena	National university of Singapore
Vyas Sekar	Carnegie Mellon University
Simha Sethumadhavan	Columbia University/Chip Scan
Srinath Setty	Microsoft Research
abhi shelat	Northeastern
Reza Shokri	National University of Singapore (NUS)
Natalie Silvanovich	Google
Asia Slowinska	IBM Security
Emily Stark	Google
Deian Stefan	UC San Diego
Gianluca Stringhini	Boston University
Vanessa Teague	university of Melbourne
Yuan Tian	University of Virginia
Mohit Tiwari	UT Austin
Selcuk Uluagac	Florida International University
Thyla van der Merwe	Mozilla
XiaoFeng Wang	Indiana University
Christo Wilson	Northeastern University
Emmett Witchel	The University of Texas at Austin
Wenyuan Xu	Zhejiang University
Danfeng (Daphne) Yao	Virginia Tech
Yuval Yarom	University of Adelaide and Data61
Yanfang (Fanny) Ye	West Virginia University
Yinqian Zhang	The Ohio State University
Saman Zonouz	Rutgers University